|||||||||||||||||||
|.................|
|.|||*|||||.|||*|.|
|.|...|.|...|.|.|
|.|||||.|||||.|||*|
|.....P...........|
|.|||*|||||.|||*|.|
|.|...|.|...|.|.|
|.|||.B.|.|||.|.|
|...|.|.|.|...|.|
|||.|.|||.|||.|.|||
|.....|.|.....|.|
|||.|.|||.|||.|.|||
|...|.|.|.|...|.|
|.|||.|.|.|||.|.|
|.|...|...|...|.|
|.|||||.|||||.|||*|
|.................|
|||||||||||||||||||